"filename", "language", "Markdown", "Java", "comment", "blank", "total"
"c:\.programering\SOP\README.md", "Markdown", 10, 0, 0, 9, 19
"c:\.programering\SOP\src\mtdm\dk\Main.java", "Java", 0, 26, 0, 7, 33
"c:\.programering\SOP\src\mtdm\dk\Point.java", "Java", 0, 20, 0, 2, 22
"c:\.programering\SOP\src\mtdm\dk\Sketch.java", "Java", 0, 187, 10, 14, 211
"c:\.programering\SOP\src\mtdm\dk\Thread.java", "Java", 0, 7, 0, 2, 9
"c:\.programering\SOP\src\mtdm\dk\bigO.java", "Java", 0, 6, 0, 2, 8
"c:\.programering\SOP\src\mtdm\dk\labyrinth\Labyrinth.java", "Java", 0, 139, 26, 10, 175
"c:\.programering\SOP\src\mtdm\dk\labyrinth\LabyrinthGen.java", "Java", 0, 136, 7, 10, 153
"c:\.programering\SOP\src\mtdm\dk\labyrinth\labyrinthSaver.java", "Java", 0, 70, 0, 6, 76
"c:\.programering\SOP\src\mtdm\dk\solvers\DepthFirstSearch.java", "Java", 0, 45, 0, 6, 51
"c:\.programering\SOP\src\mtdm\dk\solvers\ManhattanRecurse.java", "Java", 0, 63, 8, 5, 76
"c:\.programering\SOP\src\mtdm\dk\solvers\RandomRecurse.java", "Java", 0, 52, 8, 5, 65
"c:\.programering\SOP\src\mtdm\dk\solvers\Solver.java", "Java", 0, 44, 0, 2, 46
"c:\.programering\SOP\src\mtdm\dk\solvers\WallFollower.java", "Java", 0, 214, 4, 13, 231
"c:\.programering\SOP\src\mtdm\dk\solvers\WidthFirstSearch.java", "Java", 0, 45, 0, 6, 51
"c:\.programering\SOP\src\mtdm\dk\solvers\recursiveSolver.java", "Java", 0, 179, 11, 14, 204
"Total", "-", 10, 1233, 74, 113, 1430